{
    "Maze1":{
        "cell_size":50,
        "player_start":"(51,51)",
        "objective_position":"(700,500)",
        "grid":[
            [1,1,1,1,1,1,1,1,1,1,1,1,1,1,1,1,1,1,1,1],
            [1,0,0,0,0,0,0,0,0,0,1,0,0,0,0,0,0,1,0,1],
            [1,0,1,0,1,1,1,1,0,0,1,1,1,1,1,0,0,1,0,1],
            [1,0,1,0,0,0,0,1,0,0,0,0,0,0,0,0,0,1,0,1],
            [1,0,1,0,1,1,0,1,0,1,0,1,1,0,0,0,0,1,0,1],
            [1,0,1,0,1,1,0,1,0,1,0,1,1,0,0,0,0,1,0,1],
            [1,0,1,0,0,0,0,1,0,1,0,0,0,0,0,0,0,0,0,1],
            [1,0,1,1,1,1,1,1,0,1,1,1,1,1,0,0,0,1,0,1],
            [1,0,1,1,1,1,1,1,0,1,1,1,1,1,0,0,0,1,0,1],
            [1,0,1,1,1,1,1,1,0,1,1,1,1,1,0,0,0,1,1,1],
            [1,0,1,1,1,1,1,1,0,1,1,1,1,1,0,0,0,0,1,1],
            [1,0,0,0,0,0,0,0,0,0,1,0,0,0,0,0,0,0,1,1],
            [1,0,0,0,0,0,0,0,0,0,1,0,0,0,0,0,0,0,1,1],
            [1,0,0,0,0,0,0,0,0,0,1,0,0,0,0,0,0,0,1,1],
            [1,1,1,1,1,1,1,1,1,1,1,1,1,1,1,1,1,1,1,1]
        ]
    }
}